XXXXXXXXXX
XS.......X
X.XXXXXX.X
X.X....X.X
X.X.XX.X.X
X.X.XX.X.X
X.X....X.X
X.XXXXXX.X
X........E
XXXXXXXXXX